20,0,0,0,0,0,0,0,0
1,1,1,1,1,1,1,1,1
1,1,104,0,51,0,105,1,1
1,1,107,0,0,0,106,1,1
1,1,1,1,0,1,1,1,1
1,1,1,1,0,1,1,1,1
1,1,102,0,0,0,103,1,1
1,1,0,1,1,1,0,1,1
1,1,0,1,P,1,0,1,1
1,1,0,0,0,0,0,1,1
1,1,0,0,1,0,0,1,1
1,1,0,0,0,0,0,1,1
1,1,0,0,0,0,0,1,1
1,1,101,0,50,0,100,1,1
1,1,0,1,1,1,0,1,1
1,1,0,0,0,0,0,1,1
1,1,1,1,0,1,1,1,1
1,1,1,1,1,1,1,1,1
