20,0,40,30,20,0,0,0,0,0,0,0,0,0,0,0,0,0,0,0,0,0,0,0,0,0,0,0,0,0
0,0,0,0,0,0,0,0,0,0,0,0,0,0,1,0,0,1,0,0,1,0,1,1,1,1,0,1,1,1
1,1,1,1,1,1,1,1,1,1,1,1,1,1,1,1,1,1,1,1,1,1,1,1,1,1,1,1,1,1
1,0,0,0,0,0,0,0,1,1,1,1,1,0,0,0,1,0,0,0,0,0,0,0,0,1,1,1,1,1
1,0,1,0,1,1,1,0,0,0,0,0,0,0,1,0,1,0,1,1,1,0,1,0,0,0,0,0,1,1
1,0,1,0,0,0,0,0,1,1,1,1,1,0,1,0,1,0,2,2,2,0,1,1,1,1,1,0,1,1
1,0,1,1,1,1,1,0,0,0,0,0,0,0,1,0,1,0,1,1,1,0,1,0,0,0,0,0,1,1
1,0,1,0,0,0,0,0,1,1,1,1,1,0,1,0,0,0,0,0,0,0,0,52,1,1,1,1,1,1
1,0,0,53,0,1,0,1,0,0,0,0,0,0,1,0,1,1,1,1,1,1,1,0,0,0,0,0,1,1
1,0,1,0,1,1,0,1,0,2,1,0,1,1,1,0,1,0,0,0,1,1,0,0,1,1,1,0,1,1
1,0,1,0,1,1,0,1,0,1,2,0,0,0,0,0,1,0,1,0,0,1,0,1,0,0,0,0,1,1
1,0,1,0,0,0,0,0,0,0,0,0,0,1,1,1,1,0,1,1,0,0,0,1,0,1,1,0,1,1
1,0,1,1,0,0,0,0,1,1,1,1,0,1,0,0,0,0,2,2,0,1,1,1,0,2,2,0,0,1
1,0,0,1,1,1,1,0,0,0,0,0,0,0,55,1,1,0,1,1,0,0,0,0,0,1,1,1,0,1
1,1,0,1,0,0,0,0,1,0,1,0,1,1,0,0,1,0,0,0,0,0,1,1,0,0,0,0,0,1
1,1,0,1,0,1,2,0,1,0,1,0,0,1,1,0,1,1,1,0,1,0,1,1,1,1,1,1,0,1
1,1,0,1,0,2,1,0,1,0,1,1,0,0,1,0,0,0,0,0,1,0,0,0,0,0,0,1,0,1
1,1,P,0,0,0,0,0,1,0,1,1,1,0,1,0,1,1,1,1,1,0,2,2,2,2,0,0,51,1
1,1,1,1,1,1,1,1,1,0,0,0,0,0,1,0,0,0,0,0,0,0,2,1,1,1,1,1,3,1
1,1,1,1,1,1,1,1,1,1,1,1,1,1,1,1,1,1,1,1,1,1,1,1,1,1,1,1,1,1
0,0,0,0,0,0,0,0,0,0,0,0,0,0,0,0,0,0,0,0,0,0,0,0,0,0,0,0,0,0
