20,0,40,30,20,0,0,0,0,0,0,0,0,0,0,0,0,0,0,0,0,0,0,0,0,0,0,0,0,0
0,0,0,0,0,0,0,0,0,0,0,0,0,0,0,0,0,0,0,0,0,0,0,1,1,1,1,1,0,0
1,1,1,1,1,1,1,1,1,1,1,1,1,1,1,1,1,1,1,1,1,1,1,1,1,1,1,1,1,1
1,1,0,0,0,0,0,0,0,0,0,0,0,0,1,1,1,0,0,0,0,0,0,0,0,0,0,0,0,1
1,1,0,1,1,1,0,1,1,1,2,1,1,0,0,2,0,0,1,1,0,1,1,1,0,1,1,1,0,1
1,1,0,0,0,1,0,1,1,2,2,1,0,0,0,0,0,0,0,1,0,0,1,1,0,1,2,2,0,1
1,1,0,1,0,1,0,1,2,2,2,0,0,1,1,1,1,1,0,0,0,0,0,1,0,1,2,1,0,1
1,1,0,0,0,0,51,0,0,1,0,0,1,0,0,0,0,0,1,0,0,1,0,0,0,0,0,0,0,1
1,1,0,1,1,1,0,1,1,0,0,1,1,0,0,3,0,0,1,1,0,0,1,1,0,1,1,1,0,1
1,1,0,1,1,1,0,1,0,0,1,1,0,0,2,1,2,0,0,1,1,0,0,1,0,1,1,1,0,1
1,1,0,0,0,0,0,0,0,1,1,0,0,2,1,1,1,2,0,0,1,1,0,0,0,0,0,0,55,1
1,1,1,1,0,1,1,1,2,1,0,0,2,1,1,1,1,1,2,0,0,1,0,1,1,1,2,1,1,1
1,1,0,0,0,0,0,0,0,0,0,2,1,1,1,1,1,1,1,2,0,0,0,0,0,0,0,0,0,1
1,1,0,1,1,1,1,1,1,1,0,0,0,0,0,0,0,0,0,0,0,1,1,1,1,1,1,1,0,1
1,1,0,0,0,0,2,0,0,0,0,0,1,0,1,0,1,0,1,53,0,0,0,0,0,0,0,0,0,1
1,1,0,1,1,0,0,0,1,1,1,1,1,0,1,0,1,2,1,1,1,1,1,0,2,0,1,1,0,1
1,1,0,2,2,0,1,0,1,0,0,0,0,0,1,0,1,2,2,2,2,2,1,0,1,0,0,0,0,1
1,1,0,1,1,0,1,0,1,0,1,1,1,1,1,0,1,1,1,1,1,0,1,0,1,0,1,1,0,1
1,1,52,0,0,0,1,0,0,0,0,0,0,0,0,P,0,0,0,0,0,0,0,0,1,0,0,0,0,1
1,1,1,1,1,1,1,1,1,1,1,1,1,1,1,1,1,1,1,1,1,1,1,1,1,1,1,1,1,1
0,0,0,0,0,0,0,0,0,0,0,0,0,0,0,0,0,0,0,0,0,0,0,0,0,0,0,0,0,0
