20,0,40,30,20,0,0,0,0,0,0,0,0,0,0,0,0,0,0,0,0,0,0,0,0,0,0,0,0,0
0,0,0,0,0,0,0,0,0,0,0,0,0,0,0,0,0,0,0,0,0,0,0,0,0,0,0,0,0,0
1,1,1,1,1,1,1,1,1,1,1,1,1,1,1,1,1,1,1,1,1,1,1,1,1,1,1,1,1,1
1,2,2,2,2,51,1,1,1,0,0,0,0,0,0,0,0,0,0,0,0,1,1,0,0,0,0,0,0,1
1,2,1,1,1,0,1,1,1,0,1,1,0,2,3,3,2,0,1,1,0,1,1,0,1,1,1,1,0,1
1,2,1,0,0,0,0,0,1,0,1,1,0,2,2,2,2,0,1,0,0,2,2,0,0,0,2,2,0,1
1,2,1,0,1,1,1,0,0,0,0,0,0,1,0,0,1,0,1,0,1,1,1,1,1,0,1,1,0,1
1,2,1,0,1,1,1,0,1,1,1,1,0,1,0,0,1,0,1,0,1,1,1,1,1,0,1,1,0,1
1,0,0,0,0,0,0,0,0,0,1,1,0,1,0,0,1,0,0,0,0,0,0,0,0,0,0,0,0,1
1,1,1,2,1,1,1,0,1,0,1,1,0,1,0,0,1,1,1,1,0,2,0,1,1,1,1,1,0,1
1,0,0,0,0,0,0,52,1,0,0,0,0,0,0,0,0,0,0,0,0,1,0,0,0,0,0,0,0,1
1,0,1,0,1,1,1,0,1,1,1,1,1,1,0,0,1,1,1,1,1,1,2,1,1,1,0,1,0,1
1,0,1,0,1,1,1,0,2,2,2,2,0,0,0,0,0,0,0,0,0,1,0,0,0,1,0,1,0,1
1,0,1,0,0,0,0,0,1,1,1,1,0,1,0,0,1,1,1,1,0,1,0,1,0,0,0,1,0,1
1,0,1,54,0,1,1,0,0,0,0,1,0,1,0,0,1,0,0,0,0,0,0,1,1,1,1,1,0,1
1,0,1,1,0,1,0,0,0,1,0,1,0,1,0,0,1,0,1,1,2,1,0,0,0,1,50,0,0,1
1,0,2,2,2,2,2,1,1,1,0,0,0,1,0,0,1,0,0,0,2,1,1,1,0,1,0,1,0,1
1,0,1,1,1,1,2,0,0,1,1,1,0,1,0,0,1,1,1,0,1,1,0,0,0,1,0,1,0,1
1,0,0,0,0,0,0,0,0,0,0,0,0,0,P,0,0,0,0,0,0,0,0,0,0,0,0,2,0,1
1,1,1,1,1,1,1,1,1,1,1,1,1,1,1,1,1,1,1,1,1,1,1,1,1,1,1,1,1,1
0,0,0,0,0,0,0,0,0,0,0,0,0,0,0,0,0,0,0,0,0,0,0,0,0,0,0,0,0,0
