20,0,12,7,8,0,0,0,0,0,0,0,0,0,0,0,0,0,0,0,0,0,0,0,0,0,0,0,0,0
0,0,1,1,1,1,1,1,1,1,1,1,1,1,1,0,0,0,0,1,1,1,1,1,1,1,1,1,1,0
0,1,P,0,0,1,0,0,0,0,0,0,0,0,0,1,0,0,1,0,0,0,0,0,0,0,0,0,1,0
0,1,0,1,0,0,0,1,0,1,1,1,0,1,0,1,1,0,1,0,1,1,1,1,1,0,1,0,1,0
0,1,0,0,0,1,0,1,0,0,0,0,0,1,0,0,0,1,1,0,1,0,0,0,0,63,1,0,1,0
0,1,0,1,0,1,0,1,0,1,0,1,1,1,1,1,0,0,0,0,1,0,1,1,1,0,1,0,0,1
0,1,0,1,0,0,0,0,0,1,0,1,0,0,0,1,1,1,1,0,0,0,0,0,0,0,0,1,0,1
0,1,0,1,1,0,1,1,1,1,0,0,53,1,0,0,0,0,1,0,1,1,0,1,1,1,0,0,0,1
1,0,0,0,0,0,1,0,0,0,0,1,0,1,1,0,1,0,0,0,1,1,0,1,0,0,0,1,1,0
0,1,1,0,1,1,1,0,1,1,1,1,0,1,1,0,1,0,1,0,0,0,0,0,0,1,0,1,0,1
1,0,0,0,0,0,1,0,0,0,0,1,0,0,0,0,0,0,1,0,1,1,1,1,0,1,0,1,0,1
1,0,1,1,1,0,1,1,0,1,0,1,0,1,2,2,1,0,2,0,1,1,0,0,0,1,0,0,0,1
1,0,0,0,0,0,1,1,0,1,0,1,0,2,3,3,0,0,2,0,0,0,0,1,0,1,1,1,0,1
0,1,0,1,1,0,1,0,0,1,0,0,0,2,3,3,0,0,1,1,1,1,0,1,0,0,0,0,0,1
1,0,56,0,0,0,1,0,1,1,1,0,1,1,2,2,1,1,1,0,0,0,0,1,0,1,1,1,0,1
1,0,1,0,1,1,1,0,0,0,0,0,0,0,0,0,0,0,1,0,1,1,1,1,0,1,1,1,0,1
1,0,1,0,1,0,0,0,1,1,0,1,1,1,0,0,1,0,0,0,0,0,0,0,0,0,69,1,0,1
1,0,0,0,0,0,1,1,1,1,0,0,0,1,0,0,1,0,1,0,1,1,1,1,1,1,0,1,0,1
0,1,1,1,1,0,0,0,0,1,1,1,0,1,0,0,1,0,0,0,0,1,0,0,0,0,0,1,0,1
0,0,0,0,0,1,1,1,0,0,0,0,0,0,0,0,0,0,1,1,0,0,0,1,1,1,0,0,0,1
0,0,0,0,0,0,0,0,1,1,1,1,1,1,1,1,1,1,0,0,1,1,1,0,0,1,1,1,1,0