20,0,44,31,18,0,0,0,0,0,0,0,0,0,0,0,0,0,0,0,0,0,0,0,0,0,0,0,0,0
1,1,1,1,1,1,0,1,1,1,1,1,1,1,1,1,1,1,1,0,0,0,1,1,1,1,1,1,1,0
1,3,3,0,0,0,1,0,0,0,0,0,0,0,0,0,0,0,0,1,1,1,0,0,0,0,0,0,0,1
1,3,3,1,1,0,1,0,1,0,1,1,0,1,2,2,2,1,0,1,0,0,0,1,0,1,1,1,0,1
1,0,1,0,0,0,0,0,1,0,2,2,63,0,1,1,1,1,0,1,0,1,1,1,0,0,0,0,0,1
1,0,1,0,1,0,1,1,1,0,1,1,1,0,0,0,0,1,0,0,0,0,0,1,0,1,0,1,0,1
1,0,0,0,1,0,0,0,0,0,0,0,0,0,1,2,0,0,0,1,1,1,0,0,0,1,0,1,0,1
0,1,1,1,0,1,1,1,1,1,1,1,1,1,0,1,1,1,1,0,0,1,1,1,1,1,0,60,0,1
0,0,0,0,1,0,0,0,0,0,0,0,0,0,1,0,0,0,1,1,1,0,0,0,1,0,0,1,0,1
0,0,0,0,1,0,1,0,0,1,1,1,1,0,1,0,1,0,0,0,1,0,1,0,1,0,1,1,0,1
0,1,1,1,1,0,1,2,0,0,0,0,1,0,1,0,1,1,1,0,0,0,1,0,0,0,0,1,0,1
1,0,0,0,0,56,0,1,1,1,1,0,1,0,P,0,1,1,1,0,1,1,1,0,1,1,0,1,0,1
1,0,1,1,1,1,0,0,0,0,0,0,1,0,1,1,1,0,0,0,1,0,0,0,1,1,0,1,0,1
1,0,1,0,0,0,0,1,1,1,1,0,0,0,0,0,0,0,1,0,0,0,2,0,0,0,0,0,0,1
1,0,1,0,1,1,1,1,0,0,1,1,1,1,1,1,1,1,1,1,1,1,1,1,1,1,1,1,1,0
1,0,0,0,0,0,0,0,1,1,0,0,0,0,0,0,0,0,0,0,2,0,0,0,0,0,0,0,0,1
0,1,1,1,1,0,1,0,0,0,0,1,1,1,53,1,1,1,1,0,1,0,1,1,1,1,0,1,0,1
1,0,0,0,0,0,1,1,1,1,0,1,0,0,0,0,0,0,0,0,1,0,0,0,0,0,0,1,0,1
1,0,1,1,1,0,0,0,0,1,0,1,0,1,1,1,0,1,0,1,1,1,1,0,1,1,1,2,2,1
1,0,0,0,0,0,2,2,0,0,0,2,0,0,0,0,0,1,0,0,0,0,0,0,0,0,0,2,2,1
0,1,1,1,1,1,1,1,1,1,1,1,1,1,1,1,1,1,1,1,1,1,1,1,1,1,1,1,1,0