20,0,38,30,20,0,0,0,0,0,0,0,0,0,0,0,0,0,0,0,0,0,0,0,0,0,0,0,0,0
0,1,1,1,1,1,1,1,1,1,0,1,1,1,0,1,1,1,1,0,0,0,1,1,1,1,1,1,1,0
1,0,0,0,0,0,2,2,0,0,1,0,0,0,1,0,0,0,0,1,0,1,0,0,0,0,0,0,0,1
1,0,0,0,0,0,0,0,0,0,0,0,1,0,0,0,1,1,0,2,1,0,0,1,2,1,0,1,0,1
1,0,0,1,1,0,1,1,0,0,1,0,1,0,1,0,1,1,0,0,0,0,0,0,0,0,0,0,0,1
1,2,0,1,0,0,0,1,0,0,1,0,0,0,1,0,0,0,0,0,0,0,1,1,1,0,1,1,0,1
1,2,0,0,0,1,0,1,0,0,0,0,2,0,0,0,0,1,0,1,0,0,0,1,0,0,0,1,0,1
1,0,0,1,0,0,0,0,0,0,0,1,2,0,1,1,0,0,0,1,1,0,0,0,0,1,62,0,0,1
1,0,0,1,1,1,0,P,0,1,0,1,0,0,0,1,1,0,0,1,0,0,0,1,0,0,0,1,0,1
1,0,0,0,0,0,0,0,0,1,0,0,0,1,0,0,0,0,70,0,0,0,1,1,1,0,1,1,0,1
0,1,1,2,0,1,1,1,0,1,1,1,0,0,0,0,0,0,0,1,2,0,0,0,0,0,0,2,0,1
1,0,0,0,0,0,0,1,0,0,0,0,0,1,1,1,0,0,1,0,1,0,0,1,1,1,0,0,0,1
1,0,1,1,0,1,0,0,0,1,0,0,0,0,0,0,0,1,0,1,0,0,0,0,0,0,0,1,1,0
1,0,0,0,0,0,0,1,0,1,0,1,1,1,0,0,0,0,1,0,0,1,1,2,0,1,0,0,0,1
0,1,1,0,2,1,1,1,0,1,0,1,2,0,0,1,0,0,0,0,0,0,1,1,0,1,1,1,0,1
1,0,0,0,0,0,0,0,0,0,0,1,2,0,1,0,0,1,0,0,1,0,0,0,0,1,0,0,0,1
1,0,0,0,1,1,0,81,0,0,0,0,0,0,1,0,0,1,0,1,1,1,0,0,0,0,0,1,1,0
1,0,1,0,0,1,0,0,1,0,0,0,1,0,0,0,0,1,0,0,0,0,0,0,59,0,0,0,0,1
1,0,1,1,0,0,0,1,1,1,0,1,0,0,0,1,0,0,0,1,2,2,2,1,2,2,0,3,3,1
1,0,0,0,0,2,0,0,0,0,0,0,0,1,1,1,0,0,1,0,1,1,1,0,1,1,0,3,3,1
0,1,1,1,1,1,1,1,1,1,1,1,1,0,0,0,1,1,0,1,0,0,0,1,0,0,1,1,1,0