20,0,40,30,20,0,0,0,0,0,0,0,0,0,0,0,0,0,0,0,0,0,0,0,0,0,0,0,0,0
0,1,1,1,1,1,1,1,1,1,1,1,1,0,0,0,0,1,1,1,1,1,1,1,1,1,1,1,1,0
1,0,0,0,0,0,0,0,0,0,0,2,2,1,1,1,1,2,2,0,0,0,0,0,0,0,0,0,0,1
1,0,1,1,1,0,0,1,0,0,0,0,0,0,0,0,0,0,0,0,0,0,1,0,0,1,1,1,0,1
1,0,0,0,0,0,1,0,1,1,1,1,1,1,0,1,1,1,1,1,0,1,0,1,0,0,0,0,0,1
0,1,0,0,2,0,0,1,0,0,0,2,2,1,3,3,1,2,2,0,0,0,1,0,0,2,0,0,1,0
0,1,0,1,1,1,0,0,0,1,0,0,2,1,1,0,1,2,0,0,1,0,91,0,1,1,1,0,1,0
1,0,0,0,0,0,0,1,0,0,68,0,0,0,0,0,0,0,0,0,0,0,1,0,0,0,0,0,0,1
1,0,1,1,1,1,1,1,0,1,1,1,1,1,1,1,1,1,1,1,1,0,1,1,1,1,1,1,0,1
1,0,0,0,0,2,2,1,0,0,0,0,0,0,0,0,75,0,0,0,0,0,1,2,2,0,0,0,0,1
1,0,0,1,0,0,0,0,0,1,2,0,0,1,0,0,1,0,0,2,1,1,0,0,0,0,1,0,0,1
1,0,1,0,0,0,0,0,0,1,0,0,0,1,0,1,1,0,0,0,1,0,0,0,0,0,0,1,0,1
1,0,0,0,0,2,2,1,0,0,0,1,0,0,0,0,0,0,1,0,0,0,1,2,2,0,0,0,0,1
1,0,1,1,1,1,1,1,0,1,1,1,1,1,1,0,1,1,1,1,1,0,1,1,1,1,1,1,0,1
1,0,71,0,0,0,0,1,0,0,0,0,0,0,0,0,0,0,0,0,0,0,1,0,0,0,0,0,0,1
0,1,0,1,1,1,0,0,0,1,0,0,2,1,0,0,1,2,0,0,1,0,0,0,1,1,1,0,1,0
0,1,0,0,2,0,0,1,0,0,0,2,2,1,0,0,1,2,2,0,0,0,1,0,0,2,0,0,1,0
1,0,0,0,0,0,1,0,1,0,1,1,1,1,0,1,1,1,1,1,0,1,0,1,0,0,0,0,0,1
1,0,1,1,1,0,0,1,0,0,0,0,0,0,P,0,0,0,0,0,0,0,1,0,0,1,1,1,0,1
1,0,0,0,0,0,0,0,0,0,0,2,2,1,1,1,1,2,2,0,0,0,0,0,0,0,0,0,0,1
0,1,1,1,1,1,1,1,1,1,1,1,1,0,0,0,0,1,1,1,1,1,1,1,1,1,1,1,1,0